11111111
1E000011
1C0P01C1
10O00001
11111111
