11111111
1CE00011
110P01C1
10O00001
11111111
