11111111
1CE00011
110P01C1
100O0001
11111111
