11111111111111
11E00110001C11
111O01C0001011
10000000001011
1C1O0000001011
10111100001011
100C0000001011
111O1100001011
10000000001011
10000000001011
10000000001011
10001110001011
100O0000O000P1
11111111111111
